LIFE AND WRITINGS OF OVID ς

Cnunswnnnz Hislory os Roman Litoralnrc (pp. 305-311).

Mncnnlnz Latin Litoralnrc (pp. 132-144).

MIDDLETON-MILLS: Slndonls' Campanion la Lalin Anthors (pp.
200-213).

sanan: Roman Pools os lln Angnslan Ago: Horace and tao
Elcgtac Pools (Ch. V).

snscox: History ‹ofLalin Lt'lcralnrc (Vol. l, pp. 32 5-362).

Tnnsnnn: History of Roman Litoratnrc (Vol. 1, pp. 492-508)·

TYRRELL: Latin Poolry (pp. 123-125).

lllyllcalogy

Bnnssncn: Tac Ago of Fable.

COLLIGNON: Mannal os Mylhalagy.

D'OOGE: Helps lo llic Slndy os Classical Myllzol gy.

DURUY: Hislory of Romo.

GnYLEY: Classis Myllts.

Gunnnnn: Mysas of Gracco and Romo.

Hnnnmnson-Tonnnnz Grookand Roman Mythology.
Hnwsnonnn: Wondor·Boolc and T anglowood Tales.

HOMER: Iliad and Odyssoy, translated by Bryant. -

IHNE: Early Romo.

KEIGHTLEY: Myllcology of Ancionl Gracco and llaly.

KELSEY : ·0nllinos of Greek and Roman Mylhology.

Kncssnv: Tlos Heroas.- or, Greek Fairy T alos for my Clildron.
LownLL: sasan's Quosl.

Monnls: Epic of Hados.

Monnls: Life and Dcallt assason.

MURRAY: Mannal of Myllsolagy.

PECK: Harpasa Dz'clconary of Classical Lilcralnro and Antiqnilies.
SEEMANN: Myllcology of Gracco and Romo.

SEYFFERT: Diclzonary af Classical Antiqnilios.

Snrsn: Dictnnary os Greek and Roman Biograplzy and Mytnaogy.
Swlnnnnnn: Atalanta in Calydon.

Vnnnln: AEnoid, translated by Conington.

 

